1111111111111111111111
1M0000M0000011110000E1
100000000C000000000001
1P000000C000M11111C001
1111111111111111111111